,OBJECTID,KOD_ORP,NAZ_ZKR_OR,NAZ_ORP,KOD_RUIAN,KOD_OKRES,KOD_LAU1,NAZ_LAU1,KOD_KRAJ,KOD_CZNUTS,NAZ_CZNUTS,POCET_OB_9,POCET_OB_0,POCET_OB_1,SNATKY,ROZVODY,NAROZENI,ZEMRELI,PRISTEHOVA,VYSTEHOVAL,POCET_OBYV,MUZI,ZENY,OBYV_0_14,MUZI_0_14,ZENY_0_14,OBYV_15_64,MUZI_15_64,ZENY_15_64,OBYV_65,MUZI_65,ZENY_65,MIRA_NEZAM,SX,SY,SHAPE_Leng,SHAPE_Area
0,1,1000,Praha,Praha,19,40924,CZ0100,Praha,3018,CZ010,Hlavní město Praha,1214174,1169106,1268796,5531,3002,13867,12149,30473,35770,1243201,602613,640588,175353,89996,85357,842806,420646,422160,225042,91971,133071,5-Mar,-743100,-1043300,161485.487965281,496174226.305928
1,2,2101,Benešov,Benešov,27,40169,CZ0201,Benešov,3026,CZ020,Středočeský kraj,51893,52647,57655,229,191,606,567,1156,845,58165,28655,29510,9478,4856,4622,39048,19714,19334,9639,4085,5554,6-Jan,-728486,-1079285,238027.365291739,690007385.383279
2,3,2102,Beroun,Beroun,51,40177,CZ0202,Beroun,3026,CZ020,Středočeský kraj,49187,49145,57228,265,188,628,562,1578,894,58907,28933,29974,10052,5177,4875,39280,19785,19495,9575,3971,5604,7-Aug,-769499,-1053162,167029.905164065,415607985.752821
3,4,2103,Brandýs n.L.-S.Boleslav,Brandýs nad Labem-Stará Boleslav,213,40240,CZ0209,Praha-východ,3026,CZ020,Středočeský kraj,64318,65434,97039,409,292,1309,814,4157,2240,97991,48314,49677,19031,9740,9291,65608,32905,32703,13352,5669,7683,4-Feb,-724175,-1034364,212368.563110352,378085492.335997
4,5,2104,Čáslav,Čáslav,124,40207,CZ0205,Kutná Hora,3026,CZ020,Středočeský kraj,24803,24377,24682,111,63,236,318,534,424,25153,12420,12733,3650,1893,1757,16995,8676,8319,4508,1851,2657,8-Sep,-676519,-1071494,134699.905506555,274466319.897797
5,6,2105,Černošice,Černošice,230,40258,CZ020A,Praha-západ,3026,CZ020,Středočeský kraj,74265,82404,131231,510,388,1674,1022,5537,3309,131206,64572,66634,25699,13207,12492,87286,43412,43874,18221,7953,10268,4-Jul,-751952,-1056051,316752.806699747,580331396.33921
6,7,2106,Český Brod,Český Brod,108,40193,CZ0204,Kolín,3026,CZ020,Středočeský kraj,16943,16597,19303,66,53,256,184,638,430,19825,9732,10093,3570,1780,1790,13190,6673,6517,3065,1279,1786,8-Jun,-711829,-1048672,104074.931649185,184406537.23902
7,8,2107,Dobříš,Dobříš,248,40266,CZ020B,Příbram,3026,CZ020,Středočeský kraj,18276,18648,21360,104,63,274,223,577,407,21757,10796,10961,3553,1857,1696,14552,7375,7177,3652,1564,2088,9-Jan,-765577,-1074239,127048.677870517,318409372.966048
8,9,2108,Hořovice,Hořovice,60,40177,CZ0202,Beroun,3026,CZ020,Středočeský kraj,26672,26539,28932,95,55,269,352,561,448,29057,14422,14635,4380,2222,2158,19471,9968,9503,5206,2232,2974,5-Jan,-783559,-1065509,134455.601055262,246138821.967865
9,10,2109,Kladno,Kladno,78,40185,CZ0203,Kladno,3026,CZ020,Středočeský kraj,114174,114640,120058,529,375,1296,1287,2457,1851,121187,59132,62055,18991,9691,9300,81470,40919,40551,20726,8522,12204,8-Aug,-764439,-1033266,152970.92142577,350848616.09466
10,11,2110,Kolín,Kolín,94,40193,CZ0204,Kolín,3026,CZ020,Středočeský kraj,76315,74434,78814,307,230,833,878,1523,1291,80064,39611,40453,12238,6409,5829,53433,27292,26141,14393,5910,8483,9-Jun,-688356,-1056874,228808.249802302,584451064.313112
11,12,2111,Kralupy nad Vltavou,Kralupy nad Vltavou,132,40215,CZ0206,Mělník,3026,CZ020,Středočeský kraj,27097,26863,31187,116,87,311,287,813,781,30455,15083,15372,4832,2482,2350,20515,10433,10082,5108,2168,2940,6-Jan,-748236,-1025015,104596.928837371,131169827.960436
12,13,2112,Kutná Hora,Kutná Hora,116,40207,CZ0205,Kutná Hora,3026,CZ020,Středočeský kraj,50447,49251,48722,185,118,432,570,825,837,49084,24257,24827,6925,3554,3371,33142,16972,16170,9017,3731,5286,8-Sep,-684661,-1066282,237317.377385764,643089093.718618
13,14,2113,Lysá nad Labem,Lysá nad Labem,183,40231,CZ0208,Nymburk,3026,CZ020,Středočeský kraj,13097,15889,23555,130,100,326,195,944,621,23881,11723,12158,4979,2542,2437,16157,8046,8111,2745,1135,1610,8-Jan,-711964,-1034381,66354.5350625418,121092161.154423
14,15,2114,Mělník,Mělník,141,40215,CZ0206,Mělník,3026,CZ020,Středočeský kraj,40397,40202,43092,167,140,410,476,855,926,43007,21234,21773,6825,3519,3306,28802,14664,14138,7380,3051,4329,9-Apr,-735095,-1014542,190307.687110326,456730910.480814
15,16,2115,Mladá Boleslav,Mladá Boleslav,167,40223,CZ0207,Mladá Boleslav,3026,CZ020,Středočeský kraj,95461,98030,107522,433,290,1098,1007,1900,1674,108209,54416,53793,16841,8688,8153,74280,38528,35752,17088,7200,9888,4-Jun,-703949,-1011885,244588.80682261,810452499.748987
16,17,2116,Mnichovo Hradiště,Mnichovo Hradiště,175,40223,CZ0207,Mladá Boleslav,3026,CZ020,Středočeský kraj,15203,15211,16137,74,53,194,163,412,287,16734,8272,8462,2564,1326,1238,11251,5763,5488,2919,1183,1736,5-Jan,-697483,-999733,111224.855679977,212462335.19672
17,18,2117,Neratovice,Neratovice,159,40215,CZ0206,Mělník,3026,CZ020,Středočeský kraj,26747,27570,30380,118,103,320,293,789,732,30689,15187,15502,4912,2555,2357,21207,10697,10510,4570,1935,2635,9-Mar,-733399,-1025016,87811.5839330014,113100817.666789
18,19,2118,Nymburk,Nymburk,191,40231,CZ0208,Nymburk,3026,CZ020,Středočeský kraj,37062,36414,38841,153,110,341,457,873,675,39260,19214,20046,6209,3177,3032,26231,13173,13058,6820,2864,3956,8-Jun,-697398,-1038008,157653.49392173,355569967.329276
19,20,2119,Poděbrady,Poděbrady,205,40231,CZ0208,Nymburk,3026,CZ020,Středočeský kraj,29467,28849,30372,116,97,284,341,825,661,30638,14981,15657,4429,2264,2165,20214,10212,10002,5995,2505,3490,8-Aug,-692551,-1043525,145486.854619926,348655096.680948
20,21,2120,Příbram,Příbram,256,40266,CZ020B,Příbram,3026,CZ020,Středočeský kraj,70808,69763,69405,317,193,697,757,780,781,70089,34374,35715,10133,5135,4998,47816,24273,23543,12140,4966,7174,10-Jan,-778191,-1082697,256134.50517291,925271485.850591
21,22,2121,Rakovník,Rakovník,272,40274,CZ020C,Rakovník,3026,CZ020,Středočeský kraj,53545,52487,54993,232,148,576,593,928,993,55329,27569,27760,8078,4193,3885,37707,19375,18332,9544,4001,5543,8-Jan,-791278,-1034292,236781.823703693,896223942.085496
22,23,2122,Říčany,Říčany,221,40240,CZ0209,Praha-východ,3026,CZ020,Středočeský kraj,37605,40107,60107,231,200,797,471,2724,1285,61774,30385,31389,12224,6301,5923,40913,20317,20596,8637,3767,4870,3-Jan,-727707,-1055819,170505.370225646,377307190.810941
23,24,2123,Sedlčany,Sedlčany,264,40266,CZ020B,Příbram,3026,CZ020,Středočeský kraj,22923,22274,22051,73,57,176,258,310,260,22187,11037,11150,3192,1650,1542,15031,7713,7318,3964,1674,2290,8-Jan,-748897,-1090100,197162.319150901,448794866.561667
24,25,2124,Slaný,Slaný,86,40185,CZ0203,Kladno,3026,CZ020,Středočeský kraj,36451,36720,38741,160,114,466,439,900,759,39580,19511,20069,6354,3257,3097,26587,13459,13128,6639,2795,3844,8-Jun,-764264,-1023953,139669.410789937,368767058.27014
25,26,2125,Vlašim,Vlašim,35,40169,CZ0201,Benešov,3026,CZ020,Středočeský kraj,27075,26008,25482,85,59,272,268,330,334,25756,12851,12905,3591,1792,1799,17359,9010,8349,4806,2049,2757,5-Sep,-714452,-1089593,190997.74277041,495940094.822921
26,27,2126,Votice,Votice,43,40169,CZ0201,Benešov,3026,CZ020,Středočeský kraj,12651,11970,12322,37,26,137,142,250,205,12352,6074,6278,1922,971,951,8109,4139,3970,2321,964,1357,4-Sep,-734075,-1094412,161028.575699516,288892746.034832
27,28,3101,Blatná,Blatná,434,40339,CZ0316,Strakonice,3034,CZ031,Jihočeský kraj,14433,13688,13733,48,34,124,155,225,194,13833,6855,6978,1934,1044,890,9217,4649,4568,2682,1162,1520,6-Aug,-791607,-1110539,148398.130197222,278540941.51363
28,29,3102,České Budějovice,České Budějovice,302,40282,CZ0311,České Budějovice,3034,CZ031,Jihočeský kraj,144280,147795,154588,685,419,1642,1516,2293,1801,156207,75942,80265,23975,12277,11698,105374,52452,52922,26858,11213,15645,6-Jan,-755832,-1166165,224080.513591873,923756325.78338
29,30,3103,Český Krumlov,Český Krumlov,329,40291,CZ0312,Český Krumlov,3034,CZ031,Jihočeský kraj,39503,40684,41200,174,119,426,401,645,624,41685,20815,20870,6737,3421,3316,28444,14573,13871,6504,2821,3683,10-Apr,-769877,-1182590,271651.289647934,1130882602.08142
30,31,3104,Dačice,Dačice,337,40304,CZ0313,Jindřichův Hradec,3034,CZ031,Jihočeský kraj,20662,20308,19120,68,36,162,189,209,265,19518,9779,9739,2870,1491,1379,13220,6838,6382,3428,1450,1978,7-May,-684467,-1163458,189792.484221163,471682734.53759
31,32,3105,Jindřichův Hradec,Jindřichův Hradec,345,40304,CZ0313,Jindřichův Hradec,3034,CZ031,Jihočeský kraj,46607,47138,46642,189,139,437,495,542,527,47552,23325,24227,7059,3581,3478,32150,16215,15935,8343,3529,4814,6-Sep,-715043,-1152576,249802.208732529,933772551.603766
32,33,3106,Kaplice,Kaplice,311,40291,CZ0312,Český Krumlov,3034,CZ031,Jihočeský kraj,17885,18885,19316,78,71,199,174,328,457,19488,9861,9627,3143,1653,1490,13612,6995,6617,2733,1213,1520,8-Sep,-757791,-1192385,181736.617413104,484667914.133268
33,34,3107,Milevsko,Milevsko,396,40312,CZ0314,Písek,3034,CZ031,Jihočeský kraj,20062,19275,18342,78,42,187,196,211,262,18486,9149,9337,2425,1212,1213,12184,6292,5892,3877,1645,2232,5-Sep,-756860,-1112541,163525.23337699,385159285.604346
34,35,3108,Písek,Písek,400,40312,CZ0314,Písek,3034,CZ031,Jihočeský kraj,51685,51025,51501,185,159,479,594,889,734,52018,25532,26486,7738,3989,3749,34624,17482,17142,9656,4061,5595,7-Mar,-774330,-1126054,236966.023563872,741852826.107278
35,36,3109,Prachatice,Prachatice,418,40321,CZ0315,Prachatice,3034,CZ031,Jihočeský kraj,33378,33633,32746,149,82,345,315,478,531,33426,16748,16678,5230,2665,2565,22946,11842,11104,5250,2241,3009,6-Mar,-789796,-1157089,267578.457449967,839487528.796291
36,37,3110,Soběslav,Soběslav,469,40347,CZ0317,Tábor,3034,CZ031,Jihočeský kraj,22081,22020,21779,81,51,241,287,356,323,22058,10911,11147,3194,1634,1560,14659,7503,7156,4205,1774,2431,8-Apr,-733908,-1137094,138137.828973636,324052371.847299
37,38,3111,Strakonice,Strakonice,442,40339,CZ0316,Strakonice,3034,CZ031,Jihočeský kraj,46614,45194,44325,187,117,467,495,545,589,45082,22276,22806,6664,3384,3280,30424,15563,14861,7994,3329,4665,8-Jan,-792730,-1128747,173702.028441455,574204328.824854
38,39,3112,Tábor,Tábor,477,40347,CZ0317,Tábor,3034,CZ031,Jihočeský kraj,81897,80753,79336,312,251,839,868,954,984,80553,39438,41115,11914,6150,5764,53721,27062,26659,14918,6226,8692,8,-736007,-1119480,283547.76593687,1002332249.41165
39,40,3113,Trhové Sviny,Trhové Sviny,281,40282,CZ0311,České Budějovice,3034,CZ031,Jihočeský kraj,16871,17119,18250,88,56,188,176,379,300,18654,9408,9246,2877,1522,1355,12850,6631,6219,2927,1255,1672,6-Jun,-745830,-1182354,168073.694861459,452349242.721653
40,41,3114,Třeboň,Třeboň,353,40304,CZ0313,Jindřichův Hradec,3034,CZ031,Jihočeský kraj,25779,25441,24842,91,63,237,283,338,386,24932,12235,12697,3594,1842,1752,16621,8443,8178,4717,1950,2767,7-Apr,-733907,-1165848,196681.563337724,538324125.313053
41,42,3115,Týn nad Vltavou,Týn nad Vltavou,299,40282,CZ0311,České Budějovice,3034,CZ031,Jihočeský kraj,12614,13592,13624,59,33,132,131,255,264,14104,7068,7036,2152,1107,1045,9760,5043,4717,2192,918,1274,6-Jul,-755959,-1138205,128328.366584862,262402470.130438
42,43,3116,Vimperk,Vimperk,426,40321,CZ0315,Prachatice,3034,CZ031,Jihočeský kraj,17607,17736,17264,91,41,183,203,264,313,17512,8706,8806,2640,1394,1246,11860,6043,5817,3012,1269,1743,6-Mar,-805324,-1150400,167696.651749429,535376683.641659
43,44,3117,Vodňany,Vodňany,451,40339,CZ0316,Strakonice,3034,CZ031,Jihočeský kraj,10931,10981,11728,37,34,86,126,235,266,11599,5788,5811,1744,893,851,7897,4090,3807,1958,805,1153,9,-774838,-1144054,92828.8852253823,179247043.080341
44,45,3201,Blovice,Blovice,591,40380,CZ0324,Plzeň-jih,3042,CZ032,Plzeňský kraj,10792,10946,11782,52,32,120,138,283,213,11811,5874,5937,1788,929,859,7865,4026,3839,2158,919,1239,5-May,-813540,-1089625,125082.189781582,222507664.276373
45,46,3202,Domažlice,Domažlice,485,40355,CZ0321,Domažlice,3042,CZ032,Plzeňský kraj,38832,39243,39708,183,109,360,417,605,545,40299,20013,20286,6058,3057,3001,27319,14013,13306,6922,2943,3979,6-Jan,-859621,-1098483,235103.46779541,763209108.166147
46,47,3203,Horažďovice,Horažďovice,558,40363,CZ0322,Klatovy,3042,CZ032,Plzeňský kraj,12808,12258,11783,46,28,110,147,165,227,11911,5921,5990,1661,832,829,7901,4122,3779,2349,967,1382,6-May,-806272,-1120107,136853.893838362,258752357.020636
47,48,3204,Horšovský Týn,Horšovský Týn,493,40355,CZ0321,Domažlice,3042,CZ032,Plzeňský kraj,13733,13492,14051,68,42,139,136,325,276,14328,7224,7104,2282,1167,1115,9768,5053,4715,2278,1004,1274,7,-857052,-1088850,131815.215463651,288662371.568847
48,49,3205,Klatovy,Klatovy,566,40363,CZ0322,Klatovy,3042,CZ032,Plzeňský kraj,50777,50485,49988,196,134,485,542,592,688,50598,25019,25579,7522,3830,3692,34020,17297,16723,9056,3892,5164,5-Sep,-834199,-1107497,264980.091007829,906136475.741477
49,50,3206,Kralovice,Kralovice,639,40398,CZ0325,Plzeň-sever,3042,CZ032,Plzeňský kraj,22413,21941,21911,88,58,191,241,399,358,22274,11158,11116,3163,1596,1567,15161,7854,7307,3950,1708,2242,7-Mar,-810693,-1045099,238389.061182537,659237849.864016
50,51,3207,Nepomuk,Nepomuk,604,40380,CZ0324,Plzeň-jih,3042,CZ032,Plzeňský kraj,11781,11272,11475,42,23,120,162,233,209,11695,6087,5608,1612,804,808,7831,4303,3528,2252,980,1272,6-Apr,-812099,-1100639,139750.113574722,308731247.18009
51,52,3208,Nýřany,Nýřany,647,40398,CZ0325,Plzeň-sever,3042,CZ032,Plzeňský kraj,46007,47074,53029,231,152,553,471,1291,923,54399,26977,27422,8768,4493,4275,37016,18743,18273,8615,3741,4874,5-Jun,-834817,-1071853,241843.019320432,627416374.506036
52,53,3209,Plzeň,Plzeň,582,40371,CZ0323,Plzeň-město,3042,CZ032,Plzeňský kraj,188158,180748,188045,790,556,1840,1928,4019,3129,186077,90502,95575,26157,13282,12875,123942,62225,61717,35978,14995,20983,6-Jan,-822400,-1069700,131968.228198283,261382415.597795
53,54,3210,Přeštice,Přeštice,612,40380,CZ0324,Plzeň-jih,3042,CZ032,Plzeňský kraj,19756,19937,22003,86,66,169,217,447,417,22185,11171,11014,3256,1638,1618,15105,7833,7272,3824,1700,2124,5-Mar,-828466,-1088407,144334.782030163,271233925.022789
54,55,3211,Rokycany,Rokycany,655,40401,CZ0326,Rokycany,3042,CZ032,Plzeňský kraj,46118,45788,47458,175,130,448,569,768,618,47799,23814,23985,6905,3591,3314,32153,16455,15698,8741,3768,4973,5-Apr,-807014,-1072551,193568.202982751,575136021.692448
55,56,3212,Stod,Stod,621,40380,CZ0324,Plzeň-jih,3042,CZ032,Plzeňský kraj,21015,20865,23296,96,73,219,237,411,452,22715,11379,11336,3528,1835,1693,15429,7899,7530,3758,1645,2113,4-Jul,-839406,-1079288,124511.8939721,259143625.595078
56,57,3213,Stříbro,Stříbro,680,40410,CZ0327,Tachov,3042,CZ032,Plzeňský kraj,16592,16649,16589,77,54,163,170,244,311,16827,8421,8406,2394,1232,1162,11762,6065,5697,2671,1124,1547,8-Mar,-848907,-1064992,160049.867756379,430652207.019257
57,58,3214,Sušice,Sušice,574,40363,CZ0322,Klatovy,3042,CZ032,Plzeňský kraj,26081,25200,23955,102,53,235,311,394,350,24547,12070,12477,3472,1753,1719,16297,8331,7966,4778,1986,2792,9-Feb,-820752,-1128032,212370.923259812,780717452.794722
58,59,3215,Tachov,Tachov,698,40410,CZ0327,Tachov,3042,CZ032,Plzeňský kraj,33444,34790,35328,135,103,358,375,582,709,36004,18017,17987,5535,2771,2764,25395,13093,12302,5074,2153,2921,8-Mar,-874514,-1056138,221246.657046407,947822189.888179
59,60,4101,Aš,Aš,507,40428,CZ0411,Cheb,3051,CZ041,Karlovarský kraj,16502,17041,16994,84,47,203,184,393,402,17622,8770,8852,2881,1524,1357,12112,6163,5949,2629,1083,1546,6-Apr,-897769,-1003983,101962.75472754,143712868.085933
60,61,4102,Cheb,Cheb,515,40428,CZ0411,Cheb,3051,CZ041,Karlovarský kraj,47842,49655,49743,203,127,536,497,738,1102,50396,24810,25586,7918,4068,3850,34414,17430,16984,8064,3312,4752,8-May,-887798,-1021912,178786.864290884,496791456.01247
61,62,4103,Karlovy Vary,Karlovy Vary,531,40436,CZ0412,Karlovy Vary,3051,CZ041,Karlovarský kraj,91822,90534,86294,371,270,752,949,1747,1886,88633,43412,45221,12226,6182,6044,60016,30426,29590,16391,6804,9587,8-Sep,-849146,-1012216,333868.827701042,1196333741.46017
62,63,4104,Kraslice,Kraslice,663,40444,CZ0413,Sokolov,3051,CZ041,Karlovarský kraj,14078,14106,13155,49,37,131,135,313,397,13617,6878,6739,2047,1056,991,9302,4853,4449,2268,969,1299,10-Jun,-873274,-996790,107197.40038203,264473491.825002
63,64,4105,Mariánské Lázně,Mariánské Lázně,523,40428,CZ0411,Cheb,3051,CZ041,Karlovarský kraj,25512,25143,23451,108,58,208,311,584,512,24193,11683,12510,3334,1753,1581,16388,8092,8296,4471,1838,2633,6-Feb,-866718,-1038323,162765.778974695,405309286.654671
64,65,4106,Ostrov,Ostrov,540,40436,CZ0412,Karlovy Vary,3051,CZ041,Karlovarský kraj,27684,28363,29152,125,112,260,309,527,713,28664,14286,14378,4305,2181,2124,19843,10247,9596,4516,1858,2658,9-Feb,-843943,-1003512,105637.071199153,318109276.899452
65,66,4107,Sokolov,Sokolov,671,40444,CZ0413,Sokolov,3051,CZ041,Karlovarský kraj,78545,79501,76806,360,228,736,801,944,1291,77184,38330,38854,11769,6101,5668,53312,27113,26199,12103,5116,6987,10-Jun,-867189,-1013831,185730.848657562,489191801.913944
66,67,4201,Bílina,Bílina,906,40509,CZ0426,Teplice,3069,CZ042,Ústecký kraj,21448,20622,20265,65,58,201,234,1570,574,21790,11417,10373,3467,1783,1684,15166,8235,6931,3157,1399,1758,10-May,-781141,-985772,87177.8813021995,123588341.986096
67,68,4202,Děčín,Děčín,728,40452,CZ0421,Děčín,3069,CZ042,Ústecký kraj,79794,79314,76447,282,242,772,831,855,1180,78204,38608,39596,12406,6347,6059,52070,26452,25618,13728,5809,7919,11-Jun,-746700,-964459,156731.267926429,553868281.390614
68,69,4203,Chomutov,Chomutov,752,40461,CZ0422,Chomutov,3069,CZ042,Ústecký kraj,79706,81020,79788,286,224,766,823,1312,1215,81826,40704,41122,12764,6483,6281,56942,29268,27674,12120,4953,7167,12-Mar,-807671,-991726,160836.911947659,486050418.656163
69,70,4204,Kadaň,Kadaň,761,40461,CZ0422,Chomutov,3069,CZ042,Ústecký kraj,44375,43959,42369,165,114,399,477,671,976,43137,21532,21605,6522,3342,3180,30089,15486,14603,6526,2704,3822,10-May,-819377,-999449,189211.636552758,449187979.526545
70,71,4205,Litoměřice,Litoměřice,825,40479,CZ0423,Litoměřice,3069,CZ042,Ústecký kraj,57117,57645,58333,260,185,574,692,944,1006,59161,29212,29949,9168,4657,4511,40245,20478,19767,9748,4077,5671,10-Feb,-756371,-991031,188295.641975263,470590142.334742
71,72,4206,Litvínov,Litvínov,884,40495,CZ0425,Most,3069,CZ042,Ústecký kraj,41568,40169,37837,130,81,344,521,741,924,38331,19256,19075,5831,2992,2839,25752,13367,12385,6748,2897,3851,14-Jun,-791803,-978336,121856.186817096,235985869.989218
72,73,4207,Louny,Louny,850,40487,CZ0424,Louny,3069,CZ042,Ústecký kraj,43280,42850,42419,168,134,474,476,721,889,43513,21474,22039,6808,3487,3321,29661,15007,14654,7044,2980,4064,10-Aug,-782726,-1007073,191122.278783393,472595781.559134
73,74,4208,Lovosice,Lovosice,833,40479,CZ0423,Litoměřice,3069,CZ042,Ústecký kraj,26638,26569,26959,103,76,278,310,477,538,27609,13861,13748,4158,2184,1974,18299,9505,8794,5152,2172,2980,10,-762330,-992256,114098.899029036,261620664.49656
74,75,4209,Most,Most,892,40495,CZ0425,Most,3069,CZ042,Ústecký kraj,78644,77027,73938,293,195,720,825,1609,1730,76088,37540,38548,11566,5961,5605,52805,26849,25956,11717,4730,6987,12-Sep,-791642,-989344,98178.7658831542,231114438.80498
75,76,4210,Podbořany,Podbořany,868,40487,CZ0424,Louny,3069,CZ042,Ústecký kraj,15727,15715,15947,79,44,159,194,359,382,15679,7818,7861,2381,1226,1155,10743,5535,5208,2555,1057,1498,10-Apr,-811931,-1017079,144534.254236266,337619324.017017
76,77,4211,Roudnice nad Labem,Roudnice nad Labem,841,40479,CZ0423,Litoměřice,3069,CZ042,Ústecký kraj,30128,30045,31986,138,86,336,407,666,570,32300,15989,16311,5144,2665,2479,21510,10982,10528,5646,2342,3304,9-Jun,-748914,-1004233,127100.608856955,300156988.972958
77,78,4212,Rumburk,Rumburk,736,40452,CZ0421,Děčín,3069,CZ042,Ústecký kraj,32764,33866,32566,123,97,322,416,637,674,33425,16636,16789,5367,2735,2632,22655,11644,11011,5403,2257,3146,11-Feb,-720259,-949090,104350.99504333,266263293.978346
78,79,4213,Teplice,Teplice,914,40509,CZ0426,Teplice,3069,CZ042,Ústecký kraj,106424,105476,105233,438,282,990,1263,1620,1780,107006,52377,54629,16472,8542,7930,72360,36339,36021,18174,7496,10678,10-Feb,-776220,-976165,149042.402459134,345340905.485344
79,80,4214,Ústí nad Labem,Ústí nad Labem,922,40517,CZ0427,Ústí nad Labem,3069,CZ042,Ústecký kraj,118325,117780,118228,455,283,1242,1279,1744,1904,119519,58397,61122,19180,9831,9349,80307,40330,39977,20032,8236,11796,12-Aug,-760769,-976136,134512.49692435,404756982.475067
80,81,4215,Varnsdorf,Varnsdorf,744,40452,CZ0421,Děčín,3069,CZ042,Ústecký kraj,20890,20707,19821,71,66,199,198,391,442,20346,10006,10340,3182,1634,1548,13840,6986,6854,3324,1386,1938,10-Jul,-716588,-954073,56382.7885597691,88854745.1744818
81,82,4216,Žatec,Žatec,876,40487,CZ0424,Louny,3069,CZ042,Ústecký kraj,27633,27455,26825,105,85,284,331,552,512,27186,13448,13738,4384,2210,2174,18542,9478,9064,4260,1760,2500,11-Jun,-800878,-1007742,149062.282068245,307368046.632774
82,83,5101,Česká Lípa,Česká Lípa,710,40525,CZ0511,Česká Lípa,3077,CZ051,Liberecký kraj,73234,75932,74803,357,246,823,711,1187,1505,76373,37562,38811,12310,6255,6055,52923,26679,26244,11140,4628,6512,9-Mar,-725593,-978228,206364.330791035,872023460.684277
83,84,5102,Frýdlant,Frýdlant,809,40541,CZ0513,Liberec,3077,CZ051,Liberecký kraj,23555,24285,24124,111,75,244,256,330,436,24645,12192,12453,3964,1982,1982,16747,8551,8196,3934,1659,2275,11-Mar,-684266,-957225,125979.618657484,349411813.365534
84,85,5103,Jablonec nad Nisou,Jablonec nad Nisou,779,40533,CZ0512,Jablonec nad Nisou,3077,CZ051,Liberecký kraj,53177,53119,53961,241,141,598,523,1132,950,55166,26805,28361,8572,4458,4114,37079,18401,18678,9515,3946,5569,7-Feb,-680665,-979791,79490.7744225387,142311946.954686
85,86,5104,Jilemnice,Jilemnice,1139,40550,CZ0514,Semily,3077,CZ051,Liberecký kraj,23009,22973,22096,86,51,199,238,300,322,22463,11196,11267,3384,1771,1613,15078,7744,7334,4001,1681,2320,8-Apr,-658725,-995475,123331.982092366,278545978.299972
86,87,5105,Liberec,Liberec,817,40541,CZ0513,Liberec,3077,CZ051,Liberecký kraj,134914,133957,140642,620,445,1545,1393,2521,2252,141555,69141,72414,22472,11528,10944,94972,47677,47295,24111,9936,14175,8-Jun,-687904,-973739,174504.253321196,578425348.966624
87,88,5106,Nový Bor,Nový Bor,701,40525,CZ0511,Česká Lípa,3077,CZ051,Liberecký kraj,25114,25963,25953,108,92,227,254,513,506,26438,13054,13384,3958,2043,1915,17914,9059,8855,4566,1952,2614,9-Jul,-723260,-970451,86583.5801561152,200905054.818182
88,89,5107,Semily,Semily,1147,40550,CZ0514,Semily,3077,CZ051,Liberecký kraj,27403,26961,25562,99,76,253,315,373,470,25878,12800,13078,3760,1914,1846,17199,8880,8319,4919,2006,2913,9-Jun,-670835,-994757,117529.813673946,230075089.689511
89,90,5108,Tanvald,Tanvald,787,40533,CZ0512,Jablonec nad Nisou,3077,CZ051,Liberecký kraj,21707,22086,20905,74,61,179,257,361,494,21080,10346,10734,3051,1580,1471,14256,7231,7025,3773,1535,2238,8-Jun,-671042,-979545,106309.423947753,190605593.268738
90,91,5109,Turnov,Turnov,1155,40541,CZ0513,Liberec,3077,CZ051,Liberecký kraj,30718,30900,32350,132,82,338,345,571,421,32745,16072,16673,4915,2533,2382,21731,10955,10776,6099,2584,3515,6-Jul,-683594,-994784,129880.798548242,247199307.458465
91,92,5110,Železný Brod,Železný Brod,795,40533,CZ0512,Jablonec nad Nisou,3077,CZ051,Liberecký kraj,12289,12008,12043,49,42,129,131,221,250,12266,6010,6256,1810,904,906,8127,4156,3971,2329,950,1379,7-Apr,-675987,-989531,55189.3346748626,74058297.0844662
92,93,5201,Broumov,Broumov,1031,40584,CZ0523,Náchod,3085,CZ052,Královéhradecký kraj,17483,17684,16312,67,48,162,165,206,302,16568,8220,8348,2510,1328,1182,11098,5641,5457,2960,1251,1709,9-May,-600987,-1004849,117290.10011014,259360887.220859
93,94,5202,Dobruška,Dobruška,1104,40592,CZ0524,Rychnov nad Kněžnou,3085,CZ052,Královéhradecký kraj,19858,19769,19959,73,58,198,172,327,434,20212,9946,10266,3200,1637,1563,13371,6774,6597,3641,1535,2106,5-Aug,-616780,-1035940,132137.667643902,279194153.783129
94,95,5203,Dvůr Králové nad Labem,Dvůr Králové nad Labem,1201,40606,CZ0525,Trutnov,3085,CZ052,Královéhradecký kraj,27724,27231,26645,115,92,252,301,452,432,27369,13581,13788,3963,2065,1898,18219,9300,8919,5187,2216,2971,9-Mar,-639438,-1017657,126121.541407216,257805506.228827
95,96,5204,Hořice,Hořice,1007,40576,CZ0522,Jičín,3085,CZ052,Královéhradecký kraj,18424,18260,18305,71,51,171,223,283,320,18374,9077,9297,2780,1467,1313,12236,6212,6024,3358,1398,1960,7,-653169,-1023363,121440.664369967,192861294.413691
96,97,5205,Hradec Králové,Hradec Králové,965,40568,CZ0521,Hradec Králové,3085,CZ052,Královéhradecký kraj,145619,144125,145373,609,421,1455,1497,2064,2041,145157,70531,74626,21144,10788,10356,95758,48023,47735,28255,11720,16535,7-Jun,-641027,-1042391,242363.307318303,677442338.846851
97,98,5206,Jaroměř,Jaroměř,1040,40584,CZ0523,Náchod,3085,CZ052,Královéhradecký kraj,18782,19174,18864,76,52,209,222,338,425,19358,9578,9780,3113,1621,1492,12973,6615,6358,3272,1342,1930,8-Aug,-632842,-1026895,100419.929227691,138582777.228991
98,99,5207,Jičín,Jičín,1015,40576,CZ0522,Jičín,3085,CZ052,Královéhradecký kraj,46702,46207,48231,188,107,454,531,760,683,47477,23603,23874,7045,3689,3356,32050,16454,15596,8382,3460,4922,6-Mar,-671975,-1013076,201396.937811394,596742780.580632
99,100,5208,Kostelec nad Orlicí,Kostelec nad Orlicí,1112,40592,CZ0524,Rychnov nad Kněžnou,3085,CZ052,Královéhradecký kraj,24844,24516,24628,93,76,244,309,381,368,24872,12222,12650,3768,1895,1873,16488,8391,8097,4616,1936,2680,5-Aug,-615137,-1055085,112957.325027375,223543553.998735
100,101,5209,Náchod,Náchod,1066,40584,CZ0523,Náchod,3085,CZ052,Královéhradecký kraj,61330,61600,60384,240,174,594,694,771,745,61304,29911,31393,9225,4744,4481,40323,20304,20019,11756,4863,6893,5-Aug,-615005,-1022182,187533.224113494,355696613.893706
101,102,5210,Nová Paka,Nová Paka,1023,40576,CZ0522,Jičín,3085,CZ052,Královéhradecký kraj,13524,13294,13166,49,33,127,158,192,218,13317,6604,6713,1863,946,917,8869,4588,4281,2585,1070,1515,6-Apr,-659678,-1008180,75746.0824436643,97235422.6642759
102,103,5211,Nové Město nad Metují,Nové Město nad Metují,1058,40584,CZ0523,Náchod,3085,CZ052,Královéhradecký kraj,14344,14256,13990,66,38,148,141,232,245,14365,7036,7329,2146,1107,1039,9462,4781,4681,2757,1148,1609,5-Mar,-616722,-1030063,68661.4499609962,98079146.0502862
103,104,5212,Nový Bydžov,Nový Bydžov,973,40568,CZ0521,Hradec Králové,3085,CZ052,Královéhradecký kraj,17043,17053,17288,66,43,182,183,278,296,17494,8666,8828,2523,1290,1233,11911,6115,5796,3060,1261,1799,8-May,-664821,-1035901,105767.071680632,214219076.084228
104,105,5213,Rychnov nad Kněžnou,Rychnov nad Kněžnou,1121,40592,CZ0524,Rychnov nad Kněžnou,3085,CZ052,Královéhradecký kraj,33442,34009,33242,158,98,342,306,430,569,33849,16907,16942,5143,2666,2477,23040,11844,11196,5666,2397,3269,5-Jun,-610253,-1051140,184198.62416556,479414170.951029
105,106,5214,Trutnov,Trutnov,1210,40606,CZ0525,Trutnov,3085,CZ052,Královéhradecký kraj,65078,65172,63379,271,166,625,718,746,824,64210,31508,32702,9576,4949,4627,43307,22000,21307,11327,4559,6768,9-Feb,-630798,-1004195,192432.083475537,604777645.139861
106,107,5215,Vrchlabí,Vrchlabí,1228,40606,CZ0525,Trutnov,3085,CZ052,Královéhradecký kraj,28612,28374,28150,126,86,288,298,370,498,27983,13839,14144,4277,2151,2126,18829,9658,9171,4877,2030,2847,7-Aug,-651256,-994362,103646.541971733,284135756.741969
107,108,5301,Česká Třebová,Česká Třebová,1279,40649,CZ0534,Ústí nad Orlicí,3093,CZ053,Pardubický kraj,19439,19446,18208,70,44,190,223,230,302,18382,9005,9377,2717,1384,1333,12302,6214,6088,3363,1407,1956,9-Feb,-601191,-1081354,59895.4803876078,79697810.7742465
108,109,5302,Hlinsko,Hlinsko,990,40614,CZ0531,Chrudim,3093,CZ053,Pardubický kraj,22360,21824,21056,79,48,177,255,245,260,21172,10490,10682,3099,1641,1458,14158,7257,6901,3915,1592,2323,8-Feb,-641528,-1092404,145902.072363555,246817979.858691
109,110,5303,Holice,Holice,1074,40622,CZ0532,Pardubice,3093,CZ053,Pardubický kraj,15444,15480,17190,80,32,169,161,336,262,17389,8632,8757,2859,1490,1369,11659,5947,5712,2871,1195,1676,5-Aug,-632013,-1059489,100087.190226922,213728974.457428
110,111,5304,Chrudim,Chrudim,981,40614,CZ0531,Chrudim,3093,CZ053,Pardubický kraj,82302,82110,82143,355,196,817,867,1134,1154,82871,40991,41880,12414,6439,5975,56001,28531,27470,14456,6021,8435,8-Jan,-647056,-1070588,260682.366401385,746294013.460901
111,112,5305,Králíky,Králíky,1236,40649,CZ0534,Ústí nad Orlicí,3093,CZ053,Pardubický kraj,9420,9500,8712,24,15,81,93,152,190,8860,4380,4480,1311,646,665,5976,3085,2891,1573,649,924,8-Feb,-576683,-1063648,90310.224512217,158618026.188087
112,113,5306,Lanškroun,Lanškroun,1244,40649,CZ0534,Ústí nad Orlicí,3093,CZ053,Pardubický kraj,21542,21750,22727,82,60,224,231,312,258,23148,11377,11771,3717,1867,1850,15703,7936,7767,3728,1574,2154,6-Mar,-589312,-1081500,95420.3729757203,275186649.778149
113,114,5307,Litomyšl,Litomyšl,1163,40631,CZ0533,Svitavy,3093,CZ053,Pardubický kraj,25733,26219,26454,102,56,264,266,331,441,26729,13170,13559,4134,2069,2065,18088,9184,8904,4507,1917,2590,6-Jul,-611325,-1083568,119607.183881756,337038322.182273
114,115,5308,Moravská Třebová,Moravská Třebová,1171,40631,CZ0533,Svitavy,3093,CZ053,Pardubický kraj,27954,27776,26354,87,68,239,289,296,383,26560,13221,13339,3826,1947,1879,18118,9368,8750,4616,1906,2710,12-Apr,-587404,-1098959,122823.484602802,417289061.650217
115,116,5309,Pardubice,Pardubice,1082,40622,CZ0532,Pardubice,3093,CZ053,Pardubický kraj,122808,120979,126780,538,346,1294,1329,2343,2055,126476,62106,64370,18622,9670,8952,84693,42889,41804,23161,9547,13614,6-Apr,-647000,-1060800,189356.322081007,409280542.447889
116,117,5310,Polička,Polička,1180,40631,CZ0533,Svitavy,3093,CZ053,Pardubický kraj,19489,19603,19362,71,35,190,202,198,216,19641,9746,9895,3003,1504,1499,13220,6826,6394,3418,1416,2002,7-Jan,-616506,-1100600,126953.018199957,272692780.357483
117,118,5311,Přelouč,Přelouč,1091,40622,CZ0532,Pardubice,3093,CZ053,Pardubický kraj,24520,24199,24453,93,62,238,286,497,452,24704,12365,12339,3499,1788,1711,16847,8759,8088,4358,1818,2540,7-Mar,-662621,-1058768,137722.801943131,257304284.843992
118,119,5312,Svitavy,Svitavy,1198,40631,CZ0533,Svitavy,3093,CZ053,Pardubický kraj,31958,31844,31075,138,81,288,340,393,411,31692,15527,16165,4937,2469,2468,21350,10794,10556,5405,2264,3141,10-Jul,-601465,-1097654,123313.690089923,351638060.218149
119,120,5313,Ústí nad Orlicí,Ústí nad Orlicí,1287,40649,CZ0534,Ústí nad Orlicí,3093,CZ053,Pardubický kraj,26658,26793,26207,106,72,242,275,382,453,26538,13095,13443,4067,2114,1953,17721,8971,8750,4750,2010,2740,7-Sep,-604140,-1072972,98786.0139627774,190483515.023976
120,121,5314,Vysoké Mýto,Vysoké Mýto,1252,40649,CZ0534,Ústí nad Orlicí,3093,CZ053,Pardubický kraj,31121,32016,32034,104,77,367,345,420,420,32624,16158,16466,5186,2693,2493,21799,11126,10673,5639,2339,3300,6-Apr,-620932,-1073396,143871.061004553,281899055.479033
121,122,5315,Žamberk,Žamberk,1261,40649,CZ0534,Ústí nad Orlicí,3093,CZ053,Pardubický kraj,27970,28742,28872,128,65,297,230,317,469,29199,14534,14665,4545,2353,2192,19951,10167,9784,4703,2014,2689,6-Feb,-597517,-1061155,105334.191378022,281572134.519653
122,123,6101,Bystřice n.Pernštejnem,Bystřice nad Pernštejnem,1678,40690,CZ0635,Žďár nad Sázavou,3107,CZ063,Kraj Vysočina,22008,21148,19866,81,47,194,202,238,212,20190,10095,10095,2852,1456,1396,13587,7089,6498,3751,1550,2201,9-Mar,-619179,-1121753,151877.617997446,396003763.443912
123,124,6102,Havlíčkův Brod,Havlíčkův Brod,949,40657,CZ0631,Havlíčkův Brod,3107,CZ063,Kraj Vysočina,51945,51443,51787,222,120,521,537,650,648,52153,25782,26371,7966,4110,3856,34929,17791,17138,9258,3881,5377,6-Jul,-666986,-1106637,256124.177287864,631909001.009318
124,125,6103,Humpolec,Humpolec,361,40673,CZ0633,Pelhřimov,3107,CZ063,Kraj Vysočina,17292,16950,17344,60,31,173,191,204,177,17430,8584,8846,2543,1306,1237,11475,5884,5591,3412,1394,2018,6-Jan,-683778,-1111997,114146.064076004,227991807.080963
125,126,6104,Chotěboř,Chotěboř,931,40657,CZ0631,Havlíčkův Brod,3107,CZ063,Kraj Vysočina,22333,22347,21850,84,49,191,223,262,347,22221,11063,11158,3270,1669,1601,14810,7659,7151,4141,1735,2406,7-Apr,-659061,-1094954,149880.903626088,329118553.968594
126,127,6105,Jihlava,Jihlava,1503,40665,CZ0632,Jihlava,3107,CZ063,Kraj Vysočina,96442,96444,97904,410,252,1030,1016,1029,983,99479,49329,50150,15358,7906,7452,67332,34479,32853,16789,6944,9845,7-Mar,-669075,-1130105,262254.648159691,921582436.174203
127,128,6106,Moravské Budějovice,Moravské Budějovice,1571,40681,CZ0634,Třebíč,3107,CZ063,Kraj Vysočina,24616,24436,23632,77,56,207,242,261,394,23564,11767,11797,3266,1670,1596,16005,8310,7695,4293,1787,2506,10-Mar,-657923,-1169978,151134.088601495,413923294.791642
128,129,6107,Náměšť nad Oslavou,Náměšť nad Oslavou,1589,40681,CZ0634,Třebíč,3107,CZ063,Kraj Vysočina,13759,13689,13636,57,19,118,149,205,237,13387,6690,6697,1817,960,857,9033,4671,4362,2537,1059,1478,10-Mar,-630568,-1155792,112322.318977695,220804898.906281
129,130,6108,Nové Město na Moravě,Nové Město na Moravě,1686,40690,CZ0635,Žďár nad Sázavou,3107,CZ063,Kraj Vysočina,19625,19478,19004,79,30,212,164,181,229,19429,9723,9706,2992,1528,1464,12944,6654,6290,3493,1541,1952,9-Jan,-632160,-1115964,134540.853336389,292813298.942577
130,131,6109,Pacov,Pacov,370,40673,CZ0633,Pelhřimov,3107,CZ063,Kraj Vysočina,10755,10289,9756,30,20,82,140,139,149,9691,4852,4839,1263,668,595,6372,3327,3045,2056,857,1199,5-Mar,-710465,-1116532,111128.934541768,234598032.987184
131,132,6110,Pelhřimov,Pelhřimov,388,40673,CZ0633,Pelhřimov,3107,CZ063,Kraj Vysočina,46567,45745,44814,190,79,394,471,506,557,45103,22353,22750,6425,3218,3207,30237,15622,14615,8441,3513,4928,5-Jul,-695081,-1122925,252284.480608063,827329990.497009
132,133,6111,Světlá nad Sázavou,Světlá nad Sázavou,957,40657,CZ0631,Havlíčkův Brod,3107,CZ063,Kraj Vysočina,21414,20848,20162,85,52,202,242,279,319,20054,10042,10012,2662,1377,1285,13749,7169,6580,3643,1496,2147,7-Jun,-678839,-1098437,118790.864371074,290104706.744954
133,134,6112,Telč,Telč,1511,40665,CZ0632,Jihlava,3107,CZ063,Kraj Vysočina,13862,13814,13036,53,28,128,150,154,235,13156,6562,6594,1843,967,876,8845,4584,4261,2468,1011,1457,8-Sep,-681944,-1152270,134540.140146513,291326345.180376
134,135,6113,Třebíč,Třebíč,1597,40681,CZ0634,Třebíč,3107,CZ063,Kraj Vysočina,75914,76511,74425,281,197,707,703,616,850,75421,37238,38183,11125,5666,5459,51721,26326,25395,12575,5246,7329,10-Jan,-650504,-1152622,260122.870111228,837420010.882622
135,136,6114,Velké Meziříčí,Velké Meziříčí,1694,40690,CZ0635,Žďár nad Sázavou,3107,CZ063,Kraj Vysočina,34367,34976,35312,146,67,353,313,326,361,35873,17895,17978,5607,2954,2653,24451,12545,11906,5815,2396,3419,8-Feb,-639256,-1138230,220402.266111409,545100963.664379
136,137,6115,Žďár nad Sázavou,Žďár nad Sázavou,1708,40690,CZ0635,Žďár nad Sázavou,3107,CZ063,Kraj Vysočina,42841,44025,43037,188,78,408,386,324,465,43058,21295,21763,6499,3327,3172,28960,14765,14195,7599,3203,4396,7-Mar,-641841,-1114706,155034.379461235,464484825.197561
137,138,6201,Blansko,Blansko,1295,40703,CZ0641,Blansko,3115,CZ064,Jihomoravský kraj,54093,53805,55152,244,132,650,540,923,739,56270,27647,28623,8377,4251,4126,37565,19099,18466,10328,4297,6031,6-Aug,-593615,-1142450,139921.482340344,351368573.768134
138,139,6202,Boskovice,Boskovice,1309,40703,CZ0641,Blansko,3115,CZ064,Jihomoravský kraj,50013,50296,50556,193,132,535,509,627,555,51476,25409,26067,7890,4037,3853,34608,17672,16936,8978,3700,5278,8-Mar,-590923,-1128828,169349.099667108,510916541.709533
139,140,6203,Brno,Brno,1317,40711,CZ0642,Brno-město,3115,CZ064,Jihomoravský kraj,388296,376172,385913,1735,1006,4308,3871,8215,9471,377508,181963,195545,53479,27320,26159,251000,125266,125734,73029,29377,43652,8-Aug,-597977,-1161136,126501.250854651,230182890.247772
140,141,6204,Břeclav,Břeclav,1384,40738,CZ0644,Břeclav,3115,CZ064,Jihomoravský kraj,59355,59860,58778,240,136,566,570,590,646,59682,29126,30556,8397,4279,4118,41170,20822,20348,10115,4025,6090,8-Sep,-583341,-1211100,139024.754948819,438871049.656416
141,142,6205,Bučovice,Bučovice,1627,40754,CZ0646,Vyškov,3115,CZ064,Jihomoravský kraj,15641,15756,15672,77,41,174,162,280,254,15970,8011,7959,2314,1205,1109,10864,5655,5209,2792,1151,1641,8,-570138,-1168870,91588.5938287109,170880037.607599
142,143,6206,Hodonín,Hodonín,1473,40746,CZ0645,Hodonín,3115,CZ064,Jihomoravský kraj,63015,63192,60141,264,185,559,602,553,605,61307,30121,31186,8391,4336,4055,42600,21738,20862,10316,4047,6269,13-Mar,-564021,-1203029,138222.344689137,285967201.750288
143,144,6207,Hustopeče,Hustopeče,1392,40738,CZ0644,Břeclav,3115,CZ064,Jihomoravský kraj,34288,34449,34816,148,68,343,347,492,455,35536,17584,17952,5250,2718,2532,24369,12543,11826,5917,2323,3594,8-Feb,-591760,-1189876,124607.775208099,355009180.050267
144,145,6208,Ivančice,Ivančice,1325,40720,CZ0643,Brno-venkov,3115,CZ064,Jihomoravský kraj,22928,22994,23708,95,69,214,255,449,457,23993,11887,12106,3509,1736,1773,16435,8477,7958,4049,1674,2375,8-Sep,-616010,-1169274,103473.582396356,162608796.038538
145,146,6209,Kuřim,Kuřim,1333,40720,CZ0643,Brno-venkov,3115,CZ064,Jihomoravský kraj,17241,18024,22522,92,63,262,156,631,495,22198,10884,11314,3953,2039,1914,14601,7284,7317,3644,1561,2083,7-Sep,-602461,-1148719,81109.2994145941,77039629.1548072
146,147,6210,Kyjov,Kyjov,1481,40746,CZ0645,Hodonín,3115,CZ064,Jihomoravský kraj,56905,56401,54980,231,159,501,575,630,598,55790,27574,28216,7858,4067,3791,38101,19662,18439,9831,3845,5986,10-Feb,-562939,-1185117,160191.894142407,470161313.712071
147,148,6211,Mikulov,Mikulov,1406,40738,CZ0644,Břeclav,3115,CZ064,Jihomoravský kraj,19618,19888,19234,94,42,193,185,314,257,19760,9666,10094,2906,1493,1413,13673,6888,6785,3181,1285,1896,9-Sep,-600642,-1204055,101333.653812372,244118975.392386
148,149,6212,Moravský Krumlov,Moravský Krumlov,1651,40762,CZ0647,Znojmo,3115,CZ064,Jihomoravský kraj,22568,22375,21799,102,51,204,231,305,301,22212,11036,11176,3031,1557,1474,15267,7815,7452,3914,1664,2250,10-Jul,-621437,-1174544,129024.435523383,347550011.782325
149,150,6213,Pohořelice,Pohořelice,1414,40720,CZ0643,Brno-venkov,3115,CZ064,Jihomoravský kraj,12414,12399,13167,50,24,153,141,350,212,13589,6796,6793,2055,1038,1017,9420,4918,4502,2114,840,1274,9-Jun,-606798,-1183743,87655.7357203457,195282291.57378
150,151,6214,Rosice,Rosice,1341,40720,CZ0643,Brno-venkov,3115,CZ064,Jihomoravský kraj,22829,22817,24467,98,60,262,269,631,436,25092,12347,12745,3991,2058,1933,16635,8439,8196,4466,1850,2616,7-Aug,-614266,-1160419,98475.6544046123,174424163.702216
151,152,6215,Slavkov u Brna,Slavkov u Brna,1635,40754,CZ0646,Vyškov,3115,CZ064,Jihomoravský kraj,19784,19775,21658,94,55,258,219,530,357,22267,10977,11290,3628,1815,1813,15046,7703,7343,3593,1459,2134,6,-579188,-1167451,70071.7501415068,157706174.481478
152,153,6216,Šlapanice,Šlapanice,1368,40720,CZ0643,Brno-venkov,3115,CZ064,Jihomoravský kraj,49674,51197,63070,279,148,775,541,2035,1321,64446,31813,32633,11148,5779,5369,42621,21481,21140,10677,4553,6124,5-Sep,-589828,-1164609,226179.824351899,343117986.693342
153,154,6217,Tišnov,Tišnov,1350,40720,CZ0643,Brno-venkov,3115,CZ064,Jihomoravský kraj,27342,27156,29278,133,81,338,329,551,342,29996,14750,15246,4735,2417,2318,19744,10019,9725,5517,2314,3203,7-Aug,-609587,-1142320,114166.53582937,222313362.226985
154,155,6218,Veselí nad Moravou,Veselí nad Moravou,1490,40746,CZ0645,Hodonín,3115,CZ064,Jihomoravský kraj,41554,40644,38104,167,108,326,402,222,432,38645,18987,19658,5182,2626,2556,26576,13632,12944,6887,2729,4158,10-Sep,-545066,-1193215,120154.622711832,342466503.054295
155,156,6219,Vyškov,Vyškov,1643,40754,CZ0646,Vyškov,3115,CZ064,Jihomoravský kraj,50794,50585,50824,199,136,523,523,792,766,51804,25472,26332,7728,3945,3783,35389,17984,17405,8687,3543,5144,7,-568888,-1154632,175575.029317809,547200151.136373
156,157,6220,Znojmo,Znojmo,1660,40762,CZ0647,Znojmo,3115,CZ064,Jihomoravský kraj,89137,89902,89581,377,223,875,909,908,949,91122,44885,46237,13791,7143,6648,62449,31681,30768,14882,6061,8821,12-Jan,-643000,-1193738,258710.547563555,1242249474.03929
157,158,6221,Židlochovice,Židlochovice,1376,40720,CZ0643,Brno-venkov,3115,CZ064,Jihomoravský kraj,26671,27099,30088,131,81,384,293,911,637,31415,15598,15817,5273,2731,2542,21283,10884,10399,4859,1983,2876,6-May,-599236,-1178039,89409.0765786731,194244699.48156
158,159,7101,Hranice,Hranice,1970,40801,CZ0714,Přerov,3123,CZ071,Olomoucký kraj,34608,34910,33804,151,88,318,370,348,426,34492,16899,17593,5180,2632,2548,23579,11942,11637,5733,2325,3408,9-May,-512826,-1129900,130123.655812333,325389599.696881
159,160,7102,Jeseník,Jeseník,2062,40771,CZ0711,Jeseník,3123,CZ071,Olomoucký kraj,42583,42413,38779,124,112,352,420,368,579,39910,19813,20097,5645,2848,2797,27422,14147,13275,6843,2818,4025,13-Mar,-543453,-1050799,161571.605847045,719049415.842893
160,161,7103,Konice,Konice,1554,40797,CZ0713,Prostějov,3123,CZ071,Olomoucký kraj,12112,11720,10773,56,27,105,136,178,212,10984,5475,5509,1531,765,766,7442,3874,3568,2011,836,1175,9-Jan,-573228,-1119207,113974.219933668,178036569.731391
161,162,7104,Lipník nad Bečvou,Lipník nad Bečvou,1988,40801,CZ0714,Přerov,3123,CZ071,Olomoucký kraj,15476,15442,14890,61,35,141,169,181,265,15267,7545,7722,2264,1168,1096,10459,5351,5108,2544,1026,1518,10-Sep,-523731,-1131155,92120.0375411753,118639475.747955
162,163,7105,Litovel,Litovel,1881,40789,CZ0712,Olomouc,3123,CZ071,Olomoucký kraj,23540,23341,23152,89,54,247,280,374,320,23748,11845,11903,3502,1790,1712,16060,8310,7750,4186,1745,2441,8,-558527,-1108322,118238.230838175,247476628.528643
163,164,7106,Mohelnice,Mohelnice,2003,40819,CZ0715,Šumperk,3123,CZ071,Olomoucký kraj,18444,18825,18671,76,53,184,209,219,247,18592,9223,9369,2643,1360,1283,12786,6579,6207,3163,1284,1879,8-Aug,-568899,-1098783,115008.608365416,188268654.671529
164,165,7107,Olomouc,Olomouc,1899,40789,CZ0712,Olomouc,3123,CZ071,Olomoucký kraj,157056,158717,161641,710,448,1842,1594,2213,2095,162502,78337,84165,24957,12741,12216,109482,54403,55079,28063,11193,16870,9-Mar,-547169,-1121464,279112.875768893,858645901.902877
165,166,7108,Prostějov,Prostějov,1562,40797,CZ0713,Prostějov,3123,CZ071,Olomoucký kraj,100096,98170,97086,404,280,943,1063,1098,1036,98239,47731,50508,14834,7530,7304,65586,32973,32613,17819,7228,10591,8,-558538,-1133957,258276.017460911,591666442.323014
166,167,7109,Přerov,Přerov,1996,40801,CZ0714,Přerov,3123,CZ071,Olomoucký kraj,88295,85534,81388,346,227,738,939,845,1050,82255,40248,42007,11423,5885,5538,55126,28057,27069,15706,6306,9400,11-Apr,-534265,-1138237,202849.755695474,400710722.192155
167,168,7110,Šternberk,Šternberk,1911,40789,CZ0712,Olomouc,3123,CZ071,Olomoucký kraj,24512,24119,23288,89,48,239,257,313,376,23576,11657,11919,3519,1810,1709,16061,8196,7865,3996,1651,2345,10-Jun,-542220,-1106691,167153.871579188,306717389.709278
168,169,7111,Šumperk,Šumperk,2020,40819,CZ0715,Šumperk,3123,CZ071,Olomoucký kraj,73593,73601,69405,308,206,698,804,687,798,70621,34678,35943,10361,5309,5052,47556,24142,23414,12704,5227,7477,10-Sep,-563084,-1078330,173381.070367147,857606203.772882
169,170,7112,Uničov,Uničov,1902,40789,CZ0712,Olomouc,3123,CZ071,Olomoucký kraj,23091,23096,22327,73,61,212,225,251,337,22648,11183,11465,3233,1692,1541,15500,7875,7625,3915,1616,2299,10-Jan,-554496,-1100939,95084.0642325629,207442963.883306
170,171,7113,Zábřeh,Zábřeh,2011,40819,CZ0715,Šumperk,3123,CZ071,Olomoucký kraj,33935,33929,33223,145,74,303,364,431,510,33522,16384,17138,4962,2511,2451,22804,11517,11287,5756,2356,3400,9-Aug,-571061,-1086747,124974.417481843,267260334.093755
171,172,7201,Bystřice pod Hostýnem,Bystřice pod Hostýnem,1520,40827,CZ0721,Kroměříž,3131,CZ072,Zlínský kraj,15770,16015,15408,72,36,144,158,203,228,15677,7678,7999,2137,1096,1041,10672,5460,5212,2868,1122,1746,10-Jun,-518744,-1145959,84365.1754410913,163919691.476065
172,173,7202,Holešov,Holešov,1538,40827,CZ0721,Kroměříž,3131,CZ072,Zlínský kraj,21686,21620,21228,87,61,212,257,340,282,21512,10525,10987,3197,1598,1599,14433,7387,7046,3882,1540,2342,7-Sep,-526353,-1152604,79753.3389871653,132572830.460127
173,174,7203,Kroměříž,Kroměříž,1546,40827,CZ0721,Kroměříž,3131,CZ072,Zlínský kraj,70290,70176,68933,269,172,649,856,800,870,69503,33815,35688,9866,5089,4777,47316,23815,23501,12321,4911,7410,9-Apr,-540134,-1155237,171459.344705519,498872650.200996
174,175,7204,Luhačovice,Luhačovice,1422,40851,CZ0724,Zlín,3131,CZ072,Zlínský kraj,19921,19816,18754,90,37,164,196,214,301,18877,9290,9587,2595,1361,1234,12937,6622,6315,3345,1307,2038,6-Jun,-515789,-1179676,103827.898593534,178354785.424244
175,176,7205,Otrokovice,Otrokovice,1431,40851,CZ0724,Zlín,3131,CZ072,Zlínský kraj,36154,35305,34394,116,72,324,380,549,559,34655,17032,17623,5012,2614,2398,23530,11947,11583,6113,2471,3642,6-Aug,-531102,-1165935,71815.8246266947,111654027.483329
176,177,7206,Rožnov pod Radhoštěm,Rožnov pod Radhoštěm,2038,40843,CZ0723,Vsetín,3131,CZ072,Zlínský kraj,35102,35625,34817,149,67,318,334,375,369,35356,17391,17965,5099,2664,2435,23892,12112,11780,6365,2615,3750,9-Feb,-484267,-1142468,80823.9864559123,239086817.751117
177,178,7207,Uherské Hradiště,Uherské Hradiště,1601,40835,CZ0722,Uherské Hradiště,3131,CZ072,Zlínský kraj,90393,90281,89405,375,226,873,970,753,760,90307,43851,46456,12821,6456,6365,61301,31009,30292,16185,6386,9799,7-Jul,-537758,-1180953,153746.949779499,517665169.904406
178,179,7208,Uherský Brod,Uherský Brod,1619,40835,CZ0722,Uherské Hradiště,3131,CZ072,Zlínský kraj,54795,54236,52062,210,121,472,578,407,562,52822,26160,26662,7391,3905,3486,35856,18458,17398,9575,3797,5778,7-Feb,-524589,-1187195,115429.21448451,473055469.033386
179,180,7209,Valašské Klobouky,Valašské Klobouky,1449,40851,CZ0724,Zlín,3131,CZ072,Zlínský kraj,23701,24215,22991,91,34,232,288,222,231,23535,11806,11729,3511,1830,1681,16252,8490,7762,3772,1486,2286,9-Sep,-497196,-1176813,96980.0853507854,258328176.509868
180,181,7210,Valašské Meziříčí,Valašské Meziříčí,2046,40843,CZ0723,Vsetín,3131,CZ072,Zlínský kraj,42232,42009,41341,164,107,420,400,412,548,41727,20492,21235,6365,3335,3030,28011,14167,13844,7351,2990,4361,8-May,-496547,-1139895,94018.2630502071,229629049.396436
181,182,7211,Vizovice,Vizovice,1457,40851,CZ0724,Zlín,3131,CZ072,Zlínský kraj,15619,16101,16565,63,44,174,155,252,243,16830,8304,8526,2568,1260,1308,11783,6059,5724,2479,985,1494,7,-507484,-1166700,73550.6912635656,146003179.584879
182,183,7212,Vsetín,Vsetín,2054,40843,CZ0723,Vsetín,3131,CZ072,Zlínský kraj,68831,68680,65487,266,146,670,720,451,581,66485,32715,33770,9805,5116,4689,45301,23061,22240,11379,4538,6841,10-Feb,-496059,-1154800,164839.81790309,661975324.662117
183,184,7213,Zlín,Zlín,1465,40851,CZ0724,Zlín,3131,CZ072,Zlínský kraj,102409,100931,98559,431,258,933,1062,1163,1232,99013,47730,51283,14187,7269,6918,65924,32966,32958,18902,7495,11407,6-Sep,-521095,-1165015,140141.936966731,350362801.093756
184,185,8101,Bílovec,Bílovec,1830,40908,CZ0805,Opava,3140,CZ080,Moravskoslezský kraj,26067,25896,25156,115,70,267,271,458,442,25885,12803,13082,3917,2009,1908,17725,9035,8690,4243,1759,2484,8-Mar,-490505,-1108659,84358.4772971771,171599268.108584
185,186,8102,Bohumín,Bohumín,1783,40886,CZ0803,Karviná,3140,CZ080,Moravskoslezský kraj,34800,34824,33708,135,85,315,377,645,597,34037,16710,17327,4939,2569,2370,23362,11859,11503,5736,2282,3454,10-Jan,-464585,-1094423,54024.0563851504,72930769.4312278
186,187,8103,Bruntál,Bruntál,1716,40860,CZ0801,Bruntál,3140,CZ080,Moravskoslezský kraj,39036,39643,36924,133,109,357,418,476,642,37786,18618,19168,5550,2836,2714,26387,13309,13078,5849,2473,3376,15-Mar,-527562,-1079291,227757.862686937,629980571.970001
187,188,8104,Český Těšín,Český Těšín,1821,40886,CZ0803,Karviná,3140,CZ080,Moravskoslezský kraj,28711,27462,25516,105,67,242,282,479,529,26210,12723,13487,3951,1964,1987,18301,9180,9121,3958,1579,2379,10-Feb,-446778,-1113533,43803.944361572,54534930.4096843
188,189,8105,Frenštát pod Radhoštěm,Frenštát pod Radhoštěm,1848,40894,CZ0804,Nový Jičín,3140,CZ080,Moravskoslezský kraj,18317,18778,18823,74,44,196,209,279,251,19135,9408,9727,2854,1501,1353,12983,6592,6391,3298,1315,1983,7-May,-478510,-1132943,61903.0514103582,118918950.176505
189,190,8106,Frýdek-Místek,Frýdek-Místek,1741,40878,CZ0802,Frýdek-Místek,3140,CZ080,Moravskoslezský kraj,109241,108529,107481,490,317,1029,1084,1750,1582,110645,54522,56123,16439,8435,8004,76183,38603,37580,18023,7484,10539,8-Jul,-467300,-1118610,165962.460327476,480255895.236667
190,191,8107,Frýdlant nad Ostravicí,Frýdlant nad Ostravicí,1759,40878,CZ0802,Frýdek-Místek,3140,CZ080,Moravskoslezský kraj,21626,22018,23434,88,61,229,264,596,440,24062,11908,12154,3596,1814,1782,16249,8316,7933,4217,1778,2439,7-Jun,-467358,-1128937,99012.7989473143,297262742.514009
191,192,8108,Havířov,Havířov,1791,40886,CZ0803,Karviná,3140,CZ080,Moravskoslezský kraj,99830,99986,91092,383,272,803,1100,1187,2058,91151,44436,46715,12656,6485,6171,61628,31271,30357,16867,6680,10187,12-Apr,-460059,-1108675,56913.0754572778,88181587.1496287
192,193,8109,Hlučín,Hlučín,1929,40908,CZ0805,Opava,3140,CZ080,Moravskoslezský kraj,39466,39793,39465,168,91,422,432,643,573,40284,19754,20530,5940,3029,2911,27609,14026,13583,6735,2699,4036,7,-476497,-1094087,75556.726330819,165316169.069446
193,194,8110,Jablunkov,Jablunkov,1767,40878,CZ0802,Frýdek-Místek,3140,CZ080,Moravskoslezský kraj,22209,22662,22214,100,49,248,221,283,248,22773,11241,11532,3651,1859,1792,15751,8115,7636,3371,1267,2104,6-Aug,-438323,-1133116,67354.1957371722,176084097.03997
194,195,8111,Karviná,Karviná,1805,40886,CZ0803,Karviná,3140,CZ080,Moravskoslezský kraj,77737,75250,68024,274,180,583,835,778,1435,68249,33877,34372,9160,4720,4440,46567,24226,22341,12522,4931,7591,14-Jul,-451859,-1101079,79532.4269847872,105620345.093273
195,196,8112,Kopřivnice,Kopřivnice,1856,40894,CZ0804,Nový Jičín,3140,CZ080,Moravskoslezský kraj,42043,41844,40221,182,134,395,380,530,592,41209,20369,20840,6185,3163,3022,28458,14534,13924,6566,2672,3894,7-Apr,-482770,-1126864,78595.5705863995,121310400.210116
196,197,8113,Kravaře,Kravaře,1937,40908,CZ0805,Opava,3140,CZ080,Moravskoslezský kraj,20400,20768,20919,98,37,208,183,219,288,21280,10524,10756,3346,1681,1665,14894,7629,7265,3040,1214,1826,10,-489560,-1089129,70397.2104117523,100615504.25452
197,198,8114,Krnov,Krnov,1724,40860,CZ0801,Bruntál,3140,CZ080,Moravskoslezský kraj,42676,43299,40269,159,107,338,500,494,642,41370,20380,20990,5971,3089,2882,28158,14336,13822,7241,2955,4286,13-Jun,-509441,-1069703,197827.651782689,574492855.410993
198,199,8115,Nový Jičín,Nový Jičín,1864,40894,CZ0804,Nový Jičín,3140,CZ080,Moravskoslezský kraj,47607,48570,46884,177,119,478,477,667,625,48453,23700,24753,7588,3882,3706,33035,16551,16484,7830,3267,4563,7-Jun,-492507,-1126571,163305.49148147,354405134.058101
199,200,8116,Odry,Odry,1872,40894,CZ0804,Nový Jičín,3140,CZ080,Moravskoslezský kraj,17768,17678,16990,71,42,171,207,249,297,17217,8538,8679,2639,1314,1325,11806,6106,5700,2772,1118,1654,10,-504733,-1117850,83393.098656992,144945235.510012
200,201,8117,Opava,Opava,1945,40908,CZ0805,Opava,3140,CZ080,Moravskoslezský kraj,103012,103101,101046,431,260,990,1009,1071,1060,101750,49638,52112,15281,7893,7388,69483,34965,34518,16986,6780,10206,9-Feb,-496798,-1087736,206193.743837112,557727277.046862
201,202,8118,Orlová,Orlová,1813,40886,CZ0803,Karviná,3140,CZ080,Moravskoslezský kraj,44920,43478,38054,179,125,319,473,864,1108,38693,18943,19750,5434,2747,2687,27521,13870,13651,5738,2326,3412,12-Sep,-459937,-1101383,43178.7770133117,45077724.5972061
202,203,8119,Ostrava,Ostrava,1961,40916,CZ0806,Ostrava-město,3140,CZ080,Moravskoslezský kraj,353989,343559,326018,1292,892,3222,3598,4146,5219,326874,158373,168501,47228,24146,23082,221987,111308,110679,57659,22919,34740,11-Jun,-470650,-1101660,144319.539728065,331499990.098925
203,204,8120,Rýmařov,Rýmařov,1732,40860,CZ0801,Bruntál,3140,CZ080,Moravskoslezský kraj,17749,17330,15500,52,34,133,165,202,334,16016,7992,8024,2204,1175,1029,11000,5640,5360,2812,1177,1635,13,-541954,-1084209,127913.828278662,332384999.677431
204,205,8121,Třinec,Třinec,1775,40878,CZ0802,Frýdek-Místek,3140,CZ080,Moravskoslezský kraj,57030,56243,54627,234,147,528,646,609,698,55057,26970,28087,8165,4183,3982,37199,18956,18243,9693,3831,5862,6-May,-444183,-1121387,91924.9490858902,224543800.178862
205,206,8122,Vítkov,Vítkov,1953,40908,CZ0805,Opava,3140,CZ080,Moravskoslezský kraj,14492,14308,13469,45,37,130,153,226,280,13696,6844,6852,2095,1085,1010,9291,4832,4459,2310,927,1383,13-May,-509436,-1104917,122228.874179104,280179446.11151
